######################
#....................#
#....................#
#....................#
#....................#
#....................#
#....................#
#....................#
#.......P...X........#
#.......######.......#
#....................#
#####.............####
#....................#
#....................#
#..........#.........#
#....................#
#####............#####
#....................#
#....................#
#....................#
#....................#
#....................#
#.......######.......#
#....................#
#####.............####
#....................#
#....................#
#....................#
#..........#.........#
#....................#
#####............#####
#....................#
#....................#
######################