######################........................
#....................#........................
#....................#........................
#....................#........................
#....................#........................
#.............#####..#........................
#....................#........................
#....................#########################
#...............................#............#
#.......####.............................X...#
#........................#...........P.......#
#####.............############################
#....................#........................
#....................#........................
#..........#.........#........................
#....................#........................
#####............#####........................
#....................#........................
#....................#........................
#....................#........................
#..............#############################..
#.....................#....................#..
#.....................#....................#..
#.......###................................#..
#........................................###..
#..........................................#..
#...................................#......#..
#..####...............#.............#......#..
#.....................#########....##......#..
#.....................#.............#......#..
#..........#####......#####.........########..
#.....................#....................#..
#.....................#....................#..
############################################..
